H,H,H,H,H,H,H,H,H,H,H,H,H,H,H,H,H
H,1,-1,S,S,S,S,S,S,S,S,S,-1,2,S,S,H
H,-1,H,S,H,S,H,S,H,S,H,S,H,-1,S,S,H
H,S,S,S,S,S,S,S,S,S,S,S,S,S,S,S,H
H,S,H,S,H,S,H,S,H,S,H,S,H,S,S,S,H
H,S,S,S,S,S,S,S,S,S,S,S,S,S,S,S,H
H,S,H,S,H,S,H,S,H,S,H,S,H,S,S,S,H
H,S,S,S,S,S,S,S,S,S,S,S,S,S,S,S,H
H,S,H,S,H,S,H,S,H,S,H,S,H,S,S,S,H
H,S,S,S,S,S,S,S,S,S,S,S,S,S,S,S,H
H,-1,H,S,H,S,H,S,H,S,H,S,H,-1,S,S,H
H,3,-1,S,S,S,S,S,S,S,S,S,-1,4,S,S,H
H,H,H,H,H,H,H,H,H,H,H,H,H,H,H,H,H