0 0 0 0 0 0 0 0 0 0 0 0 0 0 0 0 0 0 0 0 0 0 0 0 0 0 0 0 0
0 0 0 0 0 0 0 0 0 0 0 0 0 0 0 0 0 0 0 0 0 0 0 0 0 0 0 0 0
16 1 1 1 1 1 1 1 1 1 1 1 1 1 1 1 1 1 1 1 1 1 1 1 1 1 1 1 17
15 2 2 2 2 2 2 2 2 2 2 2 2 2 2 2 2 2 2 2 2 2 2 2 2 2 2 2 15
15 2 21 1 1 17 2 21 1 1 20 2 16 1 1 1 17 2 21 1 1 20 2 16 1 1 20 2 15
15 2 2 2 2 22 2 2 2 2 2 2 15 2 2 2 15 2 2 2 2 2 2 22 2 2 2 2 15
15 2 23 2 2 2 2 16 1 1 1 17 15 2 23 2 15 16 1 1 1 17 2 2 2 2 23 2 15
15 2 15 2 23 2 2 18 1 1 1 25 19 2 22 2 18 1 1 1 1 19 2 2 23 2 15 2 15
15 2 22 2 22 2 2 2 2 2 2 2 2 2 2 2 2 2 2 2 2 2 2 2 22 2 22 2 15
15 2 2 2 2 2 23 2 21 1 1 1 1 1 24 1 1 1 1 1 20 2 23 2 2 2 2 2 15
18 24 1 20 2 2 15 2 2 2 2 2 2 2 15 2 2 2 2 2 2 2 15 2 2 21 1 24 19
0 15 2 2 2 16 25 1 1 1 1 1 20 2 22 2 21 1 1 1 1 1 25 17 2 2 2 15 0
0 15 2 16 1 19 2 2 2 2 2 2 2 2 7 2 2 2 2 2 2 2 2 18 1 17 2 15 0
0 15 2 15 2 2 2 16 1 17 2 16 1 1 1 1 1 17 2 16 1 17 2 2 2 15 2 15 0
1 19 2 22 2 21 1 19 24 22 2 15 0 0 0 0 0 15 2 22 24 18 1 20 2 22 2 18 1
6 0 2 2 2 2 2 2 2 2 2 15 0 0 14 0 0 15 2 2 2 2 2 2 2 2 0 0 5
1 17 2 23 2 21 1 17 25 23 13 15 0 0 0 0 0 15 2 23 25 16 1 20 2 23 2 16 1
0 15 2 15 2 2 2 18 1 19 2 18 1 1 1 1 1 19 2 18 1 19 2 2 2 15 2 15 0
0 15 2 18 1 17 2 2 0 0 0 0 0 0 13 0 0 0 0 0 0 2 2 16 1 19 2 0 0
0 15 2 2 2 22 2 21 1 1 1 1 1 1 24 1 1 1 1 1 1 20 2 22 2 2 2 15 0
16 25 1 20 2 2 2 2 2 2 2 2 2 2 15 2 2 2 2 2 2 2 2 2 2 21 1 25 17
15 2 2 2 2 2 2 2 21 1 1 1 20 2 22 2 21 1 1 1 20 2 2 2 2 2 2 2 15
15 3 16 1 20 2 23 2 2 2 2 2 2 2 8 2 2 2 2 2 2 2 23 2 21 1 17 3 15
15 2 15 2 2 2 22 2 21 1 1 1 1 1 1 1 1 1 1 1 20 2 22 2 2 2 15 2 15
15 2 22 2 23 2 2 2 2 2 2 2 2 2 2 2 2 2 2 2 2 2 2 2 23 2 22 2 15
15 2 2 2 22 2 16 1 1 1 1 1 1 20 2 21 1 1 1 1 1 1 17 2 22 2 2 2 15
15 2 23 2 2 2 15 2 2 2 2 2 2 2 2 2 2 2 2 2 2 2 15 2 2 2 23 2 15
15 12 18 20 2 21 19 2 21 1 20 2 21 1 1 1 20 2 21 1 20 2 18 20 2 21 19 9 15
15 2 2 2 2 2 2 2 2 2 2 2 2 2 2 2 2 2 2 2 2 2 2 2 2 2 2 2 15
18 1 1 1 1 1 1 1 1 1 1 1 1 1 1 1 1 1 1 1 1 1 1 1 1 1 1 1 19
0 0 0 0 0 0 0 0 0 0 0 0 0 0 0 0 0 0 0 0 0 0 0 0 0 0 0 0 0