0 0 0 0 0 0 0 0 0 0 0 0 0 0 0 0 0 0 0 0 0 0 0 0 0 0 0 0 0
0 0 0 0 0 0 0 0 0 0 0 0 0 0 0 0 0 0 0 0 0 0 0 0 0 0 0 0 0
16 1 1 1 1 1 1 1 1 1 1 1 24 1 1 1 24 1 1 1 1 1 1 1 1 1 1 1 17
15 9 2 2 2 2 2 2 2 2 2 2 15 2 4 2 15 2 2 2 2 2 2 2 2 2 2 10 15
15 2 16 1 1 1 1 1 1 1 20 2 22 2 23 2 22 2 21 1 1 1 1 1 1 1 17 2 15
15 3 15 2 2 2 2 2 2 2 2 2 2 2 15 2 2 2 2 2 2 2 2 2 2 2 15 3 15
15 2 22 2 23 2 16 24 24 24 17 2 23 2 15 2 23 2 16 24 24 24 17 2 23 2 22 2 15
15 2 2 2 15 2 18 25 25 25 19 2 15 2 22 2 15 2 18 25 25 25 19 2 15 2 2 2 15
26 1 20 2 15 2 2 2 2 2 2 2 15 2 2 2 15 2 2 2 2 2 2 2 15 2 21 1 27
15 2 2 2 26 1 1 20 2 21 1 1 25 1 1 1 25 1 1 20 2 21 1 1 27 2 2 2 15
15 2 16 1 19 2 2 2 2 2 2 2 2 2 2 2 2 2 2 2 2 2 2 2 18 1 17 2 15
15 2 15 2 2 2 16 22 17 2 16 1 1 1 1 1 1 1 17 2 16 22 17 2 2 2 15 2 15
15 2 22 2 21 1 25 25 19 2 18 1 1 1 1 1 1 1 19 2 18 25 25 1 20 2 22 2 15
15 2 2 2 2 2 2 2 2 2 2 2 2 2 7 2 2 2 2 2 2 2 2 2 2 2 2 2 15
26 24 24 20 2 23 2 16 1 1 1 1 1 1 1 1 1 1 1 1 1 17 2 23 2 21 24 24 27
18 25 19 2 2 15 2 15 0 0 0 0 0 0 0 0 0 0 0 0 0 15 2 15 2 2 18 25 19
6 0 0 2 21 27 2 15 0 0 0 0 0 0 14 0 0 0 0 0 0 15 2 26 20 2 0 0 5
16 24 17 2 2 15 2 15 0 0 0 0 0 0 0 0 0 0 0 0 0 15 2 15 2 2 16 24 17
26 25 25 20 2 22 2 18 1 1 1 1 1 1 1 1 1 1 1 1 1 19 2 22 2 21 25 25 27
15 2 2 2 2 2 2 0 0 0 0 0 0 0 13 0 0 0 0 0 0 0 2 2 2 2 2 2 15
15 2 23 2 21 1 1 1 1 20 2 21 1 1 1 1 1 20 2 21 1 1 1 1 20 2 23 2 15
15 2 15 2 2 2 2 2 2 2 2 2 2 2 8 2 2 2 2 2 2 2 2 2 2 2 15 2 15
15 2 18 1 1 20 2 23 2 16 1 1 20 2 23 2 21 1 1 17 2 23 2 21 1 1 19 2 15
15 2 2 2 2 2 2 15 2 15 2 2 2 2 15 2 2 2 2 15 2 15 2 2 2 2 2 2 15
26 1 1 1 1 20 2 22 2 22 2 21 1 1 25 1 1 20 2 22 2 22 2 21 1 1 1 1 27
15 2 2 2 2 2 2 2 2 2 2 2 2 2 2 2 2 2 2 2 2 2 2 2 2 2 2 2 15
15 2 21 1 1 1 1 20 2 16 1 1 20 2 23 2 21 1 1 17 2 21 1 1 1 1 20 2 15
15 3 2 2 2 2 2 2 2 15 2 2 2 2 15 2 2 2 2 15 2 2 2 2 2 2 2 3 15
15 2 21 1 1 1 1 20 2 15 2 21 1 1 25 1 1 20 2 15 2 21 1 1 1 1 20 2 15
15 11 2 2 2 2 2 2 2 15 2 2 2 2 2 2 2 2 2 15 2 2 2 2 2 2 2 12 15
18 1 1 1 1 1 1 1 1 25 1 1 1 1 1 1 1 1 1 25 1 1 1 1 1 1 1 1 19
0 0 0 0 0 0 0 0 0 0 0 0 0 0 0 0 0 0 0 0 0 0 0 0 0 0 0 0 0