0 0 0 0 0 0 0 0 0 0 0 0 0 0 0 0 0 0 0 0 0 0 0 0 0 0 0 0 0
0 0 0 0 0 0 0 0 0 0 0 0 0 0 0 0 0 0 0 0 0 0 0 0 0 0 0 0 0
16 1 1 1 1 1 1 1 1 1 1 1 1 1 24 1 1 1 1 1 1 1 1 1 1 1 1 1 17
15 2 2 2 10 2 2 2 2 2 2 2 2 2 15 2 2 2 2 2 2 2 2 2 11 2 2 2 15
15 2 16 1 1 17 2 16 1 1 1 1 17 2 15 2 16 1 1 1 1 17 2 16 1 1 17 2 15
15 3 15 0 0 15 2 15 0 0 0 0 15 2 15 2 15 0 0 0 0 15 2 15 0 0 15 3 15
15 2 18 1 1 19 2 15 0 0 0 0 15 2 15 2 15 0 0 0 0 15 2 18 1 1 19 2 15
15 2 2 2 2 2 2 18 1 1 1 1 19 2 22 2 18 1 1 1 1 19 2 2 2 2 2 2 15
15 2 21 1 20 2 2 2 2 2 2 2 2 2 4 2 2 2 2 2 2 2 2 2 21 1 20 2 15
15 2 2 2 2 2 23 2 21 1 1 1 1 1 24 1 1 1 1 1 20 2 23 2 2 2 2 2 15
18 1 1 17 2 2 15 2 2 2 2 2 2 2 15 2 2 2 2 2 2 2 15 2 2 16 1 1 19
0 0 0 15 2 16 25 1 1 1 1 1 20 2 22 2 21 1 1 1 1 1 25 17 2 15 0 0 0
0 0 0 15 2 15 2 2 2 2 2 2 2 2 7 2 2 2 2 2 2 2 2 15 2 15 0 0 0
0 0 0 15 2 15 2 16 1 1 1 1 1 1 1 1 1 1 1 1 1 17 2 15 2 15 0 0 0
1 1 1 19 2 22 2 15 0 0 0 0 0 0 0 0 0 0 0 0 0 15 2 22 2 18 1 1 1
6 0 0 0 2 2 2 15 0 0 0 0 0 0 14 0 0 0 0 0 0 15 2 2 2 0 0 0 5
1 1 1 17 2 23 2 15 0 0 0 0 0 0 0 0 0 0 0 0 0 15 2 23 2 16 1 1 1
0 0 0 15 2 15 2 18 1 1 1 1 1 1 1 1 1 1 1 1 1 19 2 15 2 15 0 0 0
0 0 0 15 2 15 2 2 0 0 0 0 0 0 13 0 0 0 0 0 0 2 2 15 2 15 0 0 0
0 0 0 15 2 22 2 21 1 1 1 1 1 1 24 1 1 1 1 1 1 20 2 22 2 15 0 0 0
16 1 1 19 2 2 2 2 2 2 2 2 2 2 15 2 2 2 2 2 2 2 2 2 2 18 1 1 17
15 2 2 2 2 2 21 1 1 1 1 1 20 2 22 2 21 1 1 1 1 1 20 2 2 2 2 2 15
15 3 21 1 17 2 2 2 2 2 2 2 2 2 8 2 2 2 2 2 2 2 2 2 16 1 20 3 15
15 2 2 2 15 2 23 2 21 1 1 1 1 1 1 1 1 1 1 1 20 2 23 2 15 2 2 2 15
26 1 20 2 22 2 15 2 2 2 2 2 2 2 2 2 2 2 2 2 2 2 15 2 22 2 21 1 27
15 2 2 2 2 2 26 1 1 1 1 1 1 20 2 21 1 1 1 1 1 1 27 2 2 2 2 2 15
15 2 21 1 1 1 27 2 2 2 2 2 2 2 2 2 2 2 2 2 2 2 26 1 1 1 20 2 15
15 12 2 2 2 2 22 2 21 1 20 2 21 1 1 1 20 2 21 1 20 2 22 2 2 2 2 9 15
18 1 1 1 17 2 2 2 2 2 2 2 2 2 2 2 2 2 2 2 2 2 2 2 16 1 1 1 19
0 0 0 0 18 1 1 1 1 1 1 1 1 1 1 1 1 1 1 1 1 1 1 1 19 0 0 0 0
0 0 0 0 0 0 0 0 0 0 0 0 0 0 0 0 0 0 0 0 0 0 0 0 0 0 0 0 0